{
  "depthLevels": [
    [
      [999, 999, 999, 999, 999, 999, 999, 999, 999, 999, 999, 999, 999, 999, 999, 999, 999, 999, 999, 999, 999, 999, 999, 999, 999, 999, 999, 999, 999],
      [999, 102, 102, 102, 102, 102, 102, 102, 102, 102, 102, 102, 102, 211, 102, 211, 102, 102, 102, 102, 102, 102, 102, 102, 102, 102, 102, 102, 999],
      [999, 102, 102, 102, 102, 102, 102, 102, 102, 102, 102, 102, 102, 211, 102, 211, 102, 102, 102, 102, 102, 102, 102, 102, 102, 102, 102, 102, 999],
      [999, 102, 102, 102, 102, 102, 102, 102, 102, 102, 102, 102, 102, 102, 211, 102, 102, 102, 102, 102, 102, 102, 102, 102, 102, 102, 102, 102, 999],
      [999, 102, 102, 102, 102, 102, 102, 102, 102, 102, 102, 102, 102, 102, 102, 102, 102, 102, 102, 102, 102, 102, 102, 102, 102, 102, 102, 102, 999],
      [999, 102, 102, 102, 102, 102, 102, 102, 102, 102, 102, 102, 102, 102, 102, 102, 102, 102, 102, 102, 102, 102, 102, 102, 102, 102, 102, 102, 999],
      [999, 102, 102, 102, 102, 102, 102, 102, 102, 102, 102, 102, 102, 102, 102, 102, 102, 102, 102, 102, 102, 102, 102, 102, 102, 102, 102, 102, 999],
      [999, 102, 102, 102, 102, 102, 102, 102, 102, 102, 102, 102, 102, 102, 102, 102, 102, 102, 102, 102, 102, 102, 102, 102, 102, 102, 102, 102, 999],
      [999, 102, 102, 102, 102, 102, 102, 102, 102, 102, 102, 102, 102, 102, 102, 102, 102, 102, 102, 102, 102, 102, 102, 102, 102, 102, 102, 102, 999],
      [999, 102, 101, 101, 102, 101, 101, 102, 102, 102, 102, 102, 102, 102, 102, 102, 102, 102, 102, 102, 102, 102, 101, 101, 102, 101, 101, 102, 999],
      [999, 101, 211, 211, 101, 211, 211, 101, 102, 102, 102, 102, 102, 102, 102, 102, 102, 102, 102, 102, 102, 101, 211, 211, 101, 211, 211, 101, 999],
      [999, 102, 101, 101, 102, 101, 101, 102, 102, 102, 102, 102, 102, 102, 102, 102, 102, 102, 102, 102, 102, 102, 101, 101, 102, 101, 101, 102, 999],
      [999, 102, 102, 102, 102, 102, 102, 102, 102, 102, 102, 102, 102, 102, 102, 102, 102, 102, 102, 102, 102, 102, 102, 102, 102, 102, 102, 102, 999],
      [999, 102, 102, 102, 102, 102, 102, 102, 102, 102, 102, 102, 102, 102, 102, 102, 102, 102, 102, 102, 102, 102, 102, 102, 102, 102, 102, 102, 999],
      [999, 102, 102, 102, 102, 102, 102, 102, 102, 102, 102, 102, 102, 102, 102, 102, 102, 102, 102, 102, 102, 102, 102, 102, 102, 102, 102, 102, 999],
      [999, 102, 102, 102, 102, 102, 102, 102, 102, 102, 102, 102, 102, 102, 102, 102, 102, 102, 102, 102, 102, 102, 102, 102, 102, 102, 102, 102, 999],
      [999, 102, 102, 102, 102, 102, 102, 102, 102, 102, 102, 102, 102, 102, 102, 102, 102, 102, 102, 102, 102, 102, 102, 102, 102, 102, 102, 102, 999],
      [999, 102, 102, 102, 102, 102, 102, 102, 102, 102, 102, 102, 102, 102, 102, 102, 102, 102, 102, 102, 102, 102, 102, 102, 102, 102, 102, 102, 999],
      [999, 102, 102, 102, 102, 102, 102, 102, 102, 102, 102, 102, 102, 102, 102, 102, 102, 102, 102, 102, 102, 102, 102, 102, 102, 102, 102, 102, 999],
      [999, 102, 102, 102, 102, 102, 102, 102, 102, 102, 102, 102, 102, 102, 102, 102, 102, 102, 102, 102, 102, 102, 102, 102, 102, 102, 102, 102, 999],
      [999, 102, 102, 102, 102, 102, 102, 102, 102, 102, 102, 102, 102, 102, 102, 102, 102, 102, 102, 102, 102, 102, 102, 102, 102, 102, 102, 102, 999],
      [999, 999, 999, 999, 999, 999, 999, 999, 999, 999, 999, 999, 999, 999, 999, 999, 999, 999, 999, 999, 999, 999, 999, 999, 999, 999, 999, 999, 999]
    ],
    [
      [201, 201, 201, 201, 201, 201, 201, 201, 201, 201, 201, 201, 201, 201, 201, 201, 201, 201, 201, 201, 201, 201, 201, 201, 201, 201, 201, 201, 201],
      [201, 999, 999, 999, 999, 999, 999, 999, 999, 999, 999, 999, 999, 999, 999, 999, 999, 999, 999, 999, 999, 999, 999, 999, 999, 999, 999, 999, 201],
      [201, 999, 202, 202, 999, 202, 202, 999, 912, 999, 999, 999, 999, 999, 912, 999, 999, 999, 999, 912, 999, 999, 202, 202, 999, 202, 202, 999, 201],
      [201, 999, 202, 202, 999, 202, 202, 999, 999, 999, 999, 999, 999, 999, 999, 999, 999, 999, 999, 999, 999, 999, 202, 202, 999, 202, 202, 999, 201],
      [201, 999, 202, 202, 999, 202, 202, 999, 999, 999, 999, 999, 999, 999, 999, 999, 999, 999, 999, 999, 999, 999, 202, 202, 999, 202, 202, 999, 201],
      [201, 999, 202, 202, 999, 202, 202, 999, 999, 202, 999, 999, 999, 202, 999, 202, 999, 999, 202, 999, 999, 999, 202, 202, 999, 202, 202, 999, 201],
      [201, 999, 999, 999, 999, 999, 999, 999, 999, 999, 999, 999, 999, 999, 202, 999, 999, 999, 999, 999, 999, 999, 999, 999, 999, 999, 999, 999, 201],
      [201, 999, 999, 999, 921, 999, 999, 999, 999, 999, 999, 999, 999, 999, 999, 999, 999, 999, 999, 999, 999, 999, 999, 999, 921, 999, 999, 999, 201],
      [201, 999, 202, 999, 202, 999, 202, 999, 999, 999, 999, 999, 999, 999, 999, 999, 999, 999, 999, 999, 999, 999, 202, 999, 202, 999, 202, 999, 201],
      [201, 999, 203, 203, 999, 203, 203, 999, 999, 999, 202, 999, 999, 999, 202, 999, 999, 999, 202, 999, 999, 999, 203, 203, 999, 203, 203, 999, 201],
      [201, 999, 999, 999, 201, 999, 999, 999, 999, 202, 201, 202, 999, 202, 201, 202, 999, 202, 201, 202, 999, 999, 999, 999, 201, 999, 999, 999, 201],
      [201, 999, 999, 999, 999, 999, 999, 999, 999, 999, 202, 999, 999, 999, 202, 999, 999, 999, 202, 999, 999, 999, 999, 999, 999, 999, 999, 999, 201],
      [201, 999, 999, 999, 999, 999, 999, 999, 999, 999, 999, 999, 999, 999, 999, 999, 999, 999, 999, 999, 999, 999, 999, 999, 999, 999, 999, 999, 201],
      [201, 999, 202, 999, 202, 999, 202, 999, 999, 999, 999, 999, 999, 999, 999, 999, 999, 999, 999, 999, 999, 999, 202, 999, 202, 202, 999, 999, 201],
      [201, 999, 999, 999, 999, 999, 999, 999, 999, 999, 999, 999, 999, 999, 999, 999, 999, 999, 999, 999, 999, 999, 999, 999, 921, 999, 999, 999, 201],
      [201, 999, 999, 999, 921, 999, 999, 999, 999, 999, 999, 999, 999, 999, 202, 999, 999, 999, 999, 999, 999, 999, 999, 999, 999, 999, 999, 999, 201],
      [201, 999, 202, 202, 999, 202, 202, 999, 999, 202, 999, 999, 999, 202, 999, 202, 999, 999, 202, 999, 999, 999, 202, 202, 999, 202, 202, 999, 201],
      [201, 999, 202, 202, 999, 202, 202, 999, 999, 999, 999, 999, 999, 999, 901, 999, 999, 999, 999, 999, 999, 999, 202, 202, 999, 202, 202, 999, 201],
      [201, 999, 202, 202, 999, 202, 202, 999, 999, 999, 999, 999, 999, 999, 202, 999, 999, 999, 999, 999, 999, 999, 202, 202, 999, 202, 202, 999, 201],
      [201, 999, 202, 202, 999, 202, 202, 999, 999, 999, 999, 999, 999, 202, 202, 202, 999, 999, 999, 999, 999, 999, 202, 202, 999, 202, 202, 999, 201],
      [201, 999, 999, 999, 999, 999, 999, 999, 999, 999, 999, 999, 999, 202, 777, 202, 999, 999, 999, 999, 999, 999, 999, 999, 999, 999, 999, 999, 201],
      [201, 201, 201, 201, 201, 201, 201, 201, 201, 201, 201, 201, 201, 201, 201, 201, 201, 201, 201, 201, 201, 201, 201, 201, 201, 201, 201, 201, 201]
    ],
    [
      [919, 999, 999, 999, 999, 999, 999, 999, 999, 999, 999, 999, 999, 999, 999, 999, 999, 999, 999, 999, 999, 999, 999, 999, 999, 999, 999, 999, 999],
      [999, 999, 999, 999, 999, 999, 999, 999, 999, 999, 999, 999, 999, 999, 999, 999, 999, 999, 999, 999, 999, 999, 999, 999, 999, 999, 999, 999, 999],
      [999, 999, 999, 999, 999, 999, 999, 999, 999, 999, 999, 999, 999, 999, 999, 999, 999, 999, 999, 999, 999, 999, 999, 999, 999, 999, 999, 999, 999],
      [999, 999, 999, 999, 999, 999, 999, 999, 999, 999, 999, 999, 999, 999, 999, 999, 999, 999, 999, 999, 999, 999, 999, 999, 999, 999, 999, 999, 999],
      [999, 999, 999, 999, 999, 999, 999, 999, 999, 999, 999, 999, 999, 999, 999, 999, 999, 999, 999, 999, 999, 999, 999, 999, 999, 999, 999, 999, 999],
      [999, 999, 999, 999, 999, 999, 999, 999, 999, 999, 999, 999, 999, 999, 999, 999, 999, 999, 999, 999, 999, 999, 999, 999, 999, 999, 999, 999, 999],
      [999, 999, 999, 999, 999, 999, 999, 999, 999, 999, 999, 999, 999, 999, 999, 999, 999, 999, 999, 999, 999, 999, 999, 999, 999, 999, 999, 999, 999],
      [999, 999, 999, 999, 999, 999, 999, 999, 999, 999, 999, 999, 999, 999, 999, 999, 999, 999, 999, 999, 999, 999, 999, 999, 999, 999, 999, 999, 999],
      [999, 999, 999, 999, 999, 999, 999, 999, 999, 999, 999, 999, 999, 999, 999, 999, 999, 999, 999, 999, 999, 999, 999, 999, 999, 999, 999, 999, 999],
      [999, 999, 999, 999, 999, 999, 999, 999, 999, 999, 999, 999, 999, 999, 999, 999, 999, 999, 999, 999, 999, 999, 999, 999, 999, 999, 999, 999, 999],
      [999, 999, 999, 999, 999, 999, 999, 999, 999, 999, 999, 999, 999, 999, 999, 999, 999, 999, 999, 999, 999, 999, 999, 999, 999, 999, 999, 999, 999],
      [999, 999, 999, 999, 999, 999, 999, 999, 999, 999, 999, 999, 999, 999, 999, 999, 999, 999, 999, 999, 999, 999, 999, 999, 999, 999, 999, 999, 999],
      [999, 999, 999, 999, 999, 999, 999, 999, 999, 999, 999, 999, 999, 999, 999, 999, 999, 999, 999, 999, 999, 999, 999, 999, 999, 999, 999, 999, 999],
      [999, 999, 999, 999, 999, 999, 999, 999, 999, 999, 999, 999, 999, 999, 999, 999, 999, 999, 999, 999, 999, 999, 999, 999, 999, 999, 999, 999, 999],
      [999, 999, 999, 999, 999, 999, 999, 999, 999, 999, 999, 999, 999, 999, 999, 999, 999, 999, 999, 999, 999, 999, 999, 999, 999, 999, 999, 999, 999],
      [999, 999, 999, 999, 999, 999, 999, 999, 999, 999, 999, 999, 999, 999, 999, 999, 999, 999, 999, 999, 999, 999, 999, 999, 999, 999, 999, 999, 999],
      [999, 999, 999, 999, 999, 999, 999, 999, 999, 999, 999, 999, 999, 999, 999, 999, 999, 999, 999, 999, 999, 999, 999, 999, 999, 999, 999, 999, 999],
      [999, 999, 999, 999, 999, 999, 999, 999, 999, 999, 999, 999, 999, 999, 999, 999, 999, 999, 999, 999, 999, 999, 999, 999, 999, 999, 999, 999, 999],
      [999, 999, 999, 999, 999, 999, 999, 999, 999, 999, 999, 999, 999, 999, 999, 999, 999, 999, 999, 999, 999, 999, 999, 999, 999, 999, 999, 999, 999],
      [999, 999, 999, 999, 999, 999, 999, 999, 999, 999, 999, 999, 999, 999, 999, 999, 999, 999, 999, 999, 999, 999, 999, 999, 999, 999, 999, 999, 999],
      [999, 999, 999, 999, 999, 999, 999, 999, 999, 999, 999, 999, 999, 999, 999, 999, 999, 999, 999, 999, 999, 999, 999, 999, 999, 999, 999, 999, 999],
      [999, 999, 999, 999, 999, 999, 999, 999, 999, 999, 999, 999, 999, 999, 999, 999, 999, 999, 999, 999, 999, 999, 999, 999, 999, 999, 999, 999, 999]
    ]
  ]
}