{
  "depthLevels": [
    [
      [999, 999, 999, 999, 999, 999, 999, 999, 999, 999, 999, 999, 999, 999, 999, 999, 999, 999, 999, 999, 999, 999, 999, 999, 999, 999, 999, 999, 999],
      [999, 103, 103, 103, 103, 103, 103, 103, 103, 103, 103, 103, 103, 103, 103, 103, 103, 103, 103, 103, 103, 103, 103, 103, 103, 103, 103, 103, 999],
      [999, 103, 103, 103, 103, 103, 103, 103, 103, 103, 103, 103, 103, 103, 103, 103, 103, 103, 103, 103, 103, 103, 103, 103, 103, 103, 103, 103, 999],
      [999, 103, 103, 103, 103, 103, 103, 103, 103, 103, 103, 103, 103, 103, 103, 103, 103, 103, 103, 103, 103, 103, 103, 103, 103, 103, 103, 103, 999],
      [999, 103, 103, 103, 103, 103, 103, 103, 103, 103, 103, 103, 103, 103, 103, 103, 103, 103, 103, 103, 103, 103, 103, 103, 103, 103, 103, 103, 999],
      [999, 103, 103, 103, 103, 103, 103, 103, 103, 103, 103, 103, 103, 103, 103, 103, 103, 103, 103, 103, 103, 103, 103, 103, 103, 103, 103, 103, 999],
      [999, 103, 103, 103, 103, 103, 103, 103, 103, 103, 103, 103, 103, 103, 103, 103, 103, 103, 103, 103, 103, 103, 103, 103, 103, 103, 103, 103, 999],
      [999, 103, 103, 103, 103, 103, 103, 103, 103, 103, 103, 103, 103, 103, 103, 103, 103, 103, 103, 103, 103, 103, 103, 103, 103, 103, 103, 103, 999],
      [999, 103, 103, 103, 103, 103, 103, 103, 103, 103, 103, 103, 103, 103, 102, 103, 103, 103, 103, 103, 103, 103, 103, 103, 103, 103, 103, 103, 999],
      [999, 103, 103, 103, 103, 103, 103, 103, 103, 103, 103, 103, 103, 102, 102, 102, 103, 103, 103, 103, 103, 103, 103, 103, 103, 103, 103, 103, 999],
      [999, 103, 103, 103, 103, 103, 103, 103, 103, 103, 103, 103, 102, 102, 102, 102, 102, 103, 103, 103, 103, 103, 103, 103, 103, 103, 103, 103, 999],
      [999, 103, 103, 103, 103, 103, 103, 103, 103, 103, 103, 103, 103, 102, 102, 102, 103, 103, 103, 103, 103, 103, 103, 103, 103, 103, 103, 103, 999],
      [999, 103, 103, 103, 103, 103, 103, 103, 103, 103, 103, 103, 103, 103, 102, 103, 103, 103, 103, 103, 103, 103, 103, 103, 103, 103, 103, 103, 999],
      [999, 103, 103, 103, 103, 103, 103, 103, 103, 103, 103, 103, 103, 103, 103, 103, 103, 103, 103, 103, 103, 103, 103, 103, 103, 103, 103, 103, 999],
      [999, 103, 103, 103, 103, 103, 103, 103, 103, 103, 103, 103, 103, 103, 103, 103, 103, 103, 103, 103, 103, 103, 103, 103, 103, 103, 103, 103, 999],
      [999, 103, 103, 103, 103, 103, 103, 103, 103, 103, 103, 103, 103, 103, 103, 103, 103, 103, 103, 103, 103, 103, 103, 103, 103, 103, 103, 103, 999],
      [999, 103, 103, 103, 103, 103, 103, 103, 103, 103, 103, 103, 103, 103, 103, 103, 103, 103, 103, 103, 103, 103, 103, 103, 103, 103, 103, 103, 999],
      [999, 103, 103, 103, 103, 103, 103, 103, 103, 103, 103, 103, 103, 103, 103, 103, 103, 103, 103, 103, 103, 103, 103, 103, 103, 103, 103, 103, 999],
      [999, 103, 103, 103, 103, 103, 103, 103, 103, 103, 103, 103, 103, 103, 103, 103, 103, 103, 103, 103, 103, 103, 103, 103, 103, 103, 103, 103, 999],
      [999, 103, 103, 103, 103, 103, 103, 103, 103, 103, 103, 103, 103, 103, 103, 103, 103, 103, 103, 103, 103, 103, 103, 103, 103, 103, 103, 103, 999],
      [999, 103, 103, 103, 103, 103, 103, 103, 103, 103, 103, 103, 103, 103, 103, 103, 103, 103, 103, 103, 103, 103, 103, 103, 103, 103, 103, 103, 999],
      [999, 999, 999, 999, 999, 999, 999, 999, 999, 999, 999, 999, 999, 999, 999, 999, 999, 999, 999, 999, 999, 999, 999, 999, 999, 999, 999, 999, 999]
    ],
    [
      [201, 201, 201, 201, 201, 201, 201, 201, 201, 201, 201, 201, 201, 201, 201, 201, 201, 201, 201, 201, 201, 201, 201, 201, 201, 201, 201, 201, 201],
      [201, 999, 999, 999, 999, 999, 999, 999, 999, 999, 999, 999, 999, 999, 999, 999, 999, 999, 999, 999, 999, 999, 999, 999, 999, 999, 999, 999, 201],
      [201, 999, 999, 999, 999, 999, 999, 999, 999, 999, 999, 999, 201, 999, 913, 999, 201, 999, 999, 999, 999, 999, 999, 999, 999, 999, 999, 999, 201],
      [201, 999, 999, 202, 202, 999, 999, 999, 202, 202, 999, 999, 201, 999, 999, 999, 201, 999, 999, 999, 999, 999, 202, 202, 202, 999, 999, 999, 201],
      [201, 999, 202, 202, 202, 202, 999, 202, 202, 202, 999, 999, 201, 999, 999, 999, 201, 999, 999, 999, 999, 999, 202, 999, 202, 999, 999, 999, 201],
      [201, 999, 999, 202, 202, 202, 202, 202, 202, 202, 999, 999, 201, 999, 921, 999, 201, 999, 999, 999, 999, 999, 999, 999, 999, 999, 999, 999, 201],
      [201, 999, 999, 202, 202, 202, 999, 202, 202, 202, 999, 999, 201, 999, 999, 999, 201, 999, 202, 999, 999, 999, 999, 999, 999, 999, 999, 999, 201],
      [201, 999, 999, 202, 202, 999, 999, 999, 202, 202, 999, 999, 999, 999, 999, 999, 999, 999, 999, 202, 999, 999, 999, 999, 999, 999, 999, 999, 201],
      [201, 999, 999, 999, 999, 999, 999, 999, 999, 999, 999, 999, 999, 999, 901, 999, 999, 999, 999, 999, 202, 999, 999, 999, 202, 999, 999, 999, 201],
      [201, 202, 999, 999, 999, 999, 202, 202, 202, 999, 999, 999, 999, 203, 202, 203, 999, 999, 999, 999, 999, 202, 999, 202, 999, 999, 999, 999, 201],
      [201, 999, 913, 999, 921, 999, 999, 999, 999, 202, 999, 999, 999, 202, 777, 202, 999, 999, 999, 999, 999, 999, 912, 202, 921, 999, 913, 999, 201],
      [201, 999, 999, 999, 999, 999, 202, 202, 202, 999, 999, 999, 999, 203, 202, 203, 999, 999, 999, 999, 999, 202, 999, 202, 999, 999, 999, 999, 201],
      [201, 999, 999, 999, 999, 999, 999, 999, 999, 999, 999, 999, 999, 999, 999, 999, 999, 999, 999, 999, 202, 999, 999, 999, 202, 999, 999, 999, 201],
      [201, 202, 999, 202, 202, 999, 999, 999, 202, 202, 999, 999, 999, 999, 999, 999, 999, 999, 999, 202, 999, 999, 999, 999, 999, 999, 999, 999, 201],
      [201, 999, 999, 202, 202, 202, 999, 202, 202, 202, 999, 999, 999, 999, 999, 999, 999, 999, 202, 999, 999, 999, 999, 999, 999, 999, 999, 999, 201],
      [201, 999, 999, 202, 202, 202, 202, 202, 202, 202, 999, 999, 201, 999, 921, 999, 201, 999, 999, 999, 999, 999, 999, 999, 999, 999, 999, 999, 201],
      [201, 999, 999, 202, 202, 202, 202, 202, 202, 202, 999, 999, 201, 999, 999, 999, 201, 999, 999, 999, 999, 999, 999, 999, 999, 999, 999, 999, 201],
      [201, 999, 999, 202, 202, 202, 999, 202, 202, 202, 999, 999, 201, 999, 999, 999, 201, 999, 999, 999, 999, 999, 202, 999, 202, 999, 999, 999, 201],
      [201, 999, 202, 201, 202, 999, 999, 999, 202, 202, 999, 999, 201, 999, 999, 999, 201, 999, 999, 999, 999, 999, 202, 202, 202, 999, 999, 999, 201],
      [201, 999, 999, 999, 999, 999, 999, 999, 999, 999, 999, 999, 201, 999, 913, 999, 201, 999, 999, 999, 999, 999, 999, 999, 999, 999, 999, 999, 201],
      [201, 999, 999, 999, 999, 999, 999, 999, 999, 999, 999, 999, 999, 999, 999, 999, 999, 999, 999, 999, 999, 999, 999, 999, 999, 999, 999, 999, 201],
      [201, 201, 201, 201, 201, 201, 201, 201, 201, 201, 201, 201, 201, 201, 201, 201, 201, 201, 201, 201, 201, 201, 201, 201, 201, 201, 201, 201, 201]
    ],
    [
      [919, 999, 999, 999, 999, 999, 999, 999, 999, 999, 999, 999, 999, 999, 999, 999, 999, 999, 999, 999, 999, 999, 999, 999, 999, 999, 999, 999, 999],
      [999, 999, 999, 999, 999, 999, 999, 999, 999, 999, 999, 999, 999, 999, 999, 999, 999, 999, 999, 999, 999, 999, 999, 999, 999, 999, 999, 999, 999],
      [999, 999, 999, 999, 999, 999, 999, 999, 999, 999, 999, 999, 999, 999, 999, 999, 999, 999, 999, 999, 999, 999, 999, 999, 999, 999, 999, 999, 999],
      [999, 999, 999, 999, 999, 999, 999, 999, 999, 999, 999, 999, 999, 999, 999, 999, 999, 999, 999, 999, 999, 999, 999, 999, 999, 999, 999, 999, 999],
      [999, 999, 999, 999, 999, 999, 999, 999, 999, 999, 999, 999, 999, 999, 999, 999, 999, 999, 999, 999, 999, 999, 999, 999, 999, 999, 999, 999, 999],
      [999, 999, 999, 999, 999, 999, 999, 999, 999, 999, 999, 999, 999, 999, 999, 999, 999, 999, 999, 999, 999, 999, 999, 999, 999, 999, 999, 999, 999],
      [999, 999, 999, 999, 999, 999, 999, 999, 999, 999, 999, 999, 999, 999, 999, 999, 999, 999, 999, 999, 999, 999, 999, 999, 999, 999, 999, 999, 999],
      [999, 999, 999, 999, 999, 999, 999, 999, 999, 999, 999, 999, 999, 999, 999, 999, 999, 999, 999, 999, 999, 999, 999, 999, 999, 999, 999, 999, 999],
      [999, 999, 999, 999, 999, 999, 999, 999, 999, 999, 999, 999, 999, 999, 999, 999, 999, 999, 999, 999, 999, 999, 999, 999, 999, 999, 999, 999, 999],
      [999, 999, 999, 999, 999, 999, 999, 999, 999, 999, 999, 999, 999, 999, 999, 999, 999, 999, 999, 999, 999, 999, 999, 999, 999, 999, 999, 999, 999],
      [999, 999, 999, 999, 999, 999, 999, 999, 999, 999, 999, 999, 999, 999, 999, 999, 999, 999, 999, 999, 999, 999, 999, 999, 999, 999, 999, 999, 999],
      [999, 999, 999, 999, 999, 999, 999, 999, 999, 999, 999, 999, 999, 999, 999, 999, 999, 999, 999, 999, 999, 999, 999, 999, 999, 999, 999, 999, 999],
      [999, 999, 999, 999, 999, 999, 999, 999, 999, 999, 999, 999, 999, 999, 999, 999, 999, 999, 999, 999, 999, 999, 999, 999, 999, 999, 999, 999, 999],
      [999, 999, 999, 999, 999, 999, 999, 999, 999, 999, 999, 999, 999, 999, 999, 999, 999, 999, 999, 999, 999, 999, 999, 999, 999, 999, 999, 999, 999],
      [999, 999, 999, 999, 999, 999, 999, 999, 999, 999, 999, 999, 999, 999, 999, 999, 999, 999, 999, 999, 999, 999, 999, 999, 999, 999, 999, 999, 999],
      [999, 999, 999, 999, 999, 999, 999, 999, 999, 999, 999, 999, 999, 999, 999, 999, 999, 999, 999, 999, 999, 999, 999, 999, 999, 999, 999, 999, 999],
      [999, 999, 999, 999, 999, 999, 999, 999, 999, 999, 999, 999, 999, 999, 999, 999, 999, 999, 999, 999, 999, 999, 999, 999, 999, 999, 999, 999, 999],
      [999, 999, 999, 999, 999, 999, 999, 999, 999, 999, 999, 999, 999, 999, 999, 999, 999, 999, 999, 999, 999, 999, 999, 999, 999, 999, 999, 999, 999],
      [999, 999, 999, 999, 999, 999, 999, 999, 999, 999, 999, 999, 999, 999, 999, 999, 999, 999, 999, 999, 999, 999, 999, 999, 999, 999, 999, 999, 999],
      [999, 999, 999, 999, 999, 999, 999, 999, 999, 999, 999, 999, 999, 999, 999, 999, 999, 999, 999, 999, 999, 999, 999, 999, 999, 999, 999, 999, 999],
      [999, 999, 999, 999, 999, 999, 999, 999, 999, 999, 999, 999, 999, 999, 999, 999, 999, 999, 999, 999, 999, 999, 999, 999, 999, 999, 999, 999, 999],
      [999, 999, 999, 999, 999, 999, 999, 999, 999, 999, 999, 999, 999, 999, 999, 999, 999, 999, 999, 999, 999, 999, 999, 999, 999, 999, 999, 999, 999]
    ]
  ]
}