{
  "depthLevels": [
    [
      [999, 999, 999, 999, 999, 999, 999, 999, 999, 999, 999, 999, 999, 999, 999, 999, 999, 999, 999, 999, 999, 999, 999, 999, 999, 999, 999, 999, 999],
      [999, 102, 102, 102, 102, 102, 102, 102, 101, 101, 102, 102, 102, 102, 101, 101, 102, 102, 102, 102, 101, 101, 102, 102, 102, 102, 102, 102, 999],
      [999, 102, 102, 101, 102, 102, 102, 102, 101, 101, 102, 102, 102, 102, 101, 101, 102, 102, 102, 102, 101, 101, 102, 102, 102, 102, 102, 102, 999],
      [999, 102, 101, 101, 102, 102, 102, 102, 101, 101, 102, 102, 102, 102, 101, 101, 102, 102, 102, 102, 101, 101, 102, 102, 102, 102, 102, 102, 999],
      [999, 102, 101, 101, 102, 102, 102, 102, 101, 101, 102, 102, 102, 102, 101, 101, 102, 102, 102, 102, 101, 101, 102, 102, 102, 102, 102, 102, 999],
      [999, 102, 103, 103, 102, 102, 102, 102, 101, 101, 102, 102, 102, 102, 101, 101, 102, 102, 102, 102, 102, 101, 102, 102, 102, 102, 101, 102, 999],
      [999, 102, 103, 103, 102, 102, 102, 102, 103, 103, 102, 102, 102, 102, 101, 101, 102, 102, 102, 102, 101, 101, 102, 102, 102, 101, 101, 102, 999],
      [999, 211, 103, 103, 211, 211, 102, 102, 103, 103, 102, 102, 102, 102, 103, 103, 102, 102, 102, 102, 101, 101, 102, 102, 102, 101, 101, 102, 999],
      [999, 211, 103, 103, 211, 211, 211, 211, 103, 103, 211, 211, 211, 102, 103, 103, 102, 102, 102, 102, 103, 103, 102, 102, 102, 103, 103, 102, 999],
      [999, 102, 103, 103, 102, 211, 211, 211, 103, 103, 211, 211, 211, 211, 103, 103, 211, 102, 102, 102, 103, 103, 102, 102, 102, 103, 103, 102, 999],
      [999, 102, 103, 103, 102, 102, 102, 102, 103, 103, 102, 102, 102, 211, 103, 103, 211, 211, 211, 211, 103, 103, 211, 211, 211, 103, 103, 211, 999],
      [999, 102, 101, 101, 102, 102, 102, 102, 103, 103, 102, 102, 102, 102, 103, 103, 102, 211, 211, 211, 103, 103, 211, 211, 211, 103, 103, 211, 999],
      [999, 102, 102, 101, 102, 102, 102, 102, 101, 101, 102, 102, 102, 102, 103, 103, 102, 102, 102, 102, 103, 103, 102, 102, 102, 103, 103, 102, 999],
      [999, 102, 102, 102, 102, 102, 102, 102, 101, 101, 102, 102, 102, 102, 101, 101, 102, 102, 102, 102, 103, 103, 102, 102, 102, 103, 103, 102, 999],
      [999, 102, 102, 102, 102, 102, 102, 102, 101, 101, 102, 102, 102, 102, 101, 101, 102, 102, 102, 102, 101, 101, 102, 102, 102, 101, 101, 102, 999],
      [999, 102, 102, 102, 102, 102, 102, 102, 101, 101, 102, 102, 102, 102, 101, 101, 102, 102, 102, 102, 101, 101, 102, 102, 102, 101, 101, 102, 999],
      [999, 102, 102, 102, 102, 102, 102, 102, 101, 101, 101, 101, 101, 101, 101, 101, 101, 101, 101, 101, 101, 102, 102, 102, 102, 101, 101, 102, 999],
      [999, 102, 102, 102, 102, 102, 102, 102, 101, 101, 101, 101, 101, 101, 101, 101, 101, 101, 101, 101, 102, 102, 102, 102, 102, 101, 102, 102, 999],
      [999, 102, 102, 102, 102, 102, 102, 102, 102, 102, 102, 102, 102, 102, 101, 101, 102, 102, 102, 102, 102, 102, 102, 102, 102, 102, 102, 102, 999],
      [999, 102, 102, 102, 102, 102, 102, 102, 102, 102, 102, 102, 102, 101, 101, 101, 101, 102, 102, 102, 102, 102, 102, 102, 102, 102, 102, 102, 999],
      [999, 102, 102, 102, 102, 102, 102, 102, 102, 102, 102, 102, 102, 101, 101, 101, 101, 102, 102, 102, 102, 102, 102, 102, 102, 102, 102, 102, 999],
      [999, 999, 999, 999, 999, 999, 999, 999, 999, 999, 999, 999, 999, 999, 999, 999, 999, 999, 999, 999, 999, 999, 999, 999, 999, 999, 999, 999, 999]
    ],
    [
      [201, 201, 201, 201, 201, 201, 201, 201, 201, 201, 201, 201, 201, 201, 201, 201, 201, 201, 201, 201, 201, 201, 201, 201, 201, 201, 201, 201, 201],
      [201, 999, 999, 203, 999, 999, 999, 999, 999, 999, 999, 999, 999, 999, 999, 999, 999, 999, 999, 999, 999, 999, 999, 999, 999, 999, 999, 999, 201],
      [201, 999, 203, 999, 999, 202, 202, 202, 999, 999, 999, 913, 999, 999, 921, 999, 999, 202, 202, 202, 999, 999, 999, 999, 999, 999, 202, 999, 201],
      [201, 999, 999, 999, 999, 202, 913, 202, 999, 999, 999, 999, 999, 999, 999, 999, 999, 202, 913, 202, 999, 999, 999, 999, 202, 202, 202, 999, 201],
      [201, 999, 999, 999, 999, 999, 999, 999, 999, 999, 999, 202, 202, 999, 999, 999, 999, 999, 999, 999, 999, 999, 999, 999, 202, 999, 203, 999, 201],
      [201, 999, 999, 999, 999, 999, 999, 999, 999, 999, 999, 999, 999, 999, 999, 999, 999, 999, 999, 999, 203, 999, 999, 999, 202, 203, 999, 999, 201],
      [201, 203, 999, 999, 203, 203, 999, 999, 999, 999, 999, 999, 999, 999, 999, 999, 999, 202, 202, 999, 999, 999, 999, 999, 999, 999, 999, 999, 201],
      [201, 999, 999, 999, 999, 999, 203, 203, 999, 999, 203, 203, 203, 999, 999, 999, 999, 999, 999, 999, 999, 999, 999, 999, 999, 999, 921, 999, 201],
      [201, 999, 999, 999, 999, 999, 999, 999, 999, 999, 999, 999, 999, 203, 999, 999, 203, 203, 999, 999, 999, 999, 999, 999, 999, 999, 999, 999, 201],
      [201, 203, 999, 999, 203, 999, 999, 999, 999, 999, 999, 999, 999, 999, 999, 999, 999, 202, 203, 203, 999, 999, 203, 203, 203, 999, 999, 203, 201],
      [201, 999, 999, 999, 999, 203, 203, 203, 999, 999, 203, 202, 202, 999, 999, 999, 999, 999, 999, 999, 999, 999, 999, 999, 999, 999, 999, 999, 201],
      [201, 999, 921, 999, 999, 999, 999, 999, 999, 999, 999, 203, 203, 203, 999, 999, 203, 999, 999, 999, 999, 999, 999, 999, 999, 999, 999, 999, 201],
      [201, 999, 203, 999, 999, 999, 999, 999, 999, 999, 999, 999, 999, 999, 999, 999, 999, 203, 203, 203, 999, 999, 203, 203, 203, 999, 999, 203, 201],
      [201, 999, 999, 203, 999, 999, 999, 999, 999, 999, 999, 999, 999, 999, 999, 999, 999, 999, 999, 999, 999, 999, 999, 999, 999, 999, 999, 999, 201],
      [201, 999, 999, 999, 999, 999, 999, 999, 999, 999, 999, 202, 202, 999, 999, 999, 999, 999, 999, 999, 999, 999, 999, 999, 999, 999, 999, 999, 201],
      [201, 999, 999, 999, 999, 202, 999, 202, 999, 999, 999, 999, 999, 999, 999, 999, 999, 202, 202, 999, 999, 999, 999, 999, 999, 999, 999, 999, 201],
      [201, 999, 202, 202, 999, 202, 202, 202, 999, 999, 999, 999, 999, 999, 901, 999, 999, 999, 999, 999, 999, 202, 999, 999, 999, 999, 999, 999, 201],
      [201, 999, 202, 201, 202, 999, 999, 999, 999, 999, 999, 999, 999, 999, 921, 999, 999, 999, 999, 999, 202, 999, 999, 202, 202, 999, 203, 999, 201],
      [201, 999, 202, 202, 999, 999, 999, 999, 999, 999, 999, 999, 999, 999, 202, 999, 999, 999, 999, 999, 999, 999, 999, 999, 202, 203, 999, 999, 201],
      [201, 999, 999, 999, 999, 999, 999, 999, 999, 999, 999, 999, 999, 202, 202, 202, 999, 999, 999, 999, 999, 999, 999, 202, 202, 999, 999, 999, 201],
      [201, 912, 999, 999, 999, 999, 999, 999, 999, 999, 999, 999, 999, 202, 777, 202, 999, 999, 999, 999, 999, 999, 999, 999, 999, 999, 999, 999, 201],
      [201, 201, 201, 201, 201, 201, 201, 201, 201, 201, 201, 201, 201, 201, 201, 201, 201, 201, 201, 201, 201, 201, 201, 201, 201, 201, 201, 201, 201]
    ],
    [
      [917, 999, 999, 999, 999, 999, 999, 999, 999, 999, 999, 999, 999, 999, 999, 999, 999, 999, 999, 999, 999, 999, 999, 999, 999, 999, 999, 999, 999],
      [999, 999, 999, 999, 999, 999, 999, 999, 999, 999, 112, 112, 112, 112, 999, 999, 999, 999, 999, 999, 999, 999, 999, 999, 999, 999, 999, 999, 999],
      [999, 999, 999, 999, 999, 999, 999, 999, 999, 999, 112, 112, 112, 112, 999, 999, 999, 999, 999, 999, 999, 999, 999, 999, 999, 999, 999, 999, 999],
      [999, 999, 999, 999, 999, 999, 112, 999, 999, 999, 999, 112, 112, 999, 999, 999, 999, 999, 112, 999, 999, 999, 999, 999, 999, 999, 999, 999, 999],
      [999, 999, 999, 999, 999, 112, 112, 112, 999, 999, 999, 999, 999, 999, 999, 999, 999, 112, 112, 112, 999, 999, 999, 999, 999, 999, 999, 999, 999],
      [999, 999, 999, 999, 999, 999, 999, 999, 999, 999, 999, 999, 999, 999, 999, 999, 999, 999, 999, 999, 999, 999, 999, 999, 999, 999, 999, 999, 999],
      [999, 999, 999, 999, 999, 999, 999, 999, 999, 999, 999, 999, 999, 999, 999, 999, 999, 999, 999, 999, 999, 999, 999, 999, 999, 999, 999, 999, 999],
      [999, 999, 999, 999, 999, 999, 999, 999, 999, 999, 999, 999, 999, 999, 999, 999, 999, 999, 999, 999, 999, 999, 999, 999, 999, 999, 999, 999, 999],
      [999, 999, 999, 999, 999, 999, 999, 999, 999, 999, 999, 999, 999, 999, 999, 999, 999, 999, 999, 999, 999, 999, 999, 999, 999, 999, 999, 999, 999],
      [999, 999, 999, 999, 999, 999, 999, 999, 999, 999, 999, 999, 999, 999, 999, 999, 999, 999, 999, 999, 999, 999, 999, 999, 999, 999, 999, 999, 999],
      [999, 999, 999, 999, 999, 999, 999, 999, 999, 999, 999, 999, 999, 999, 999, 999, 999, 999, 999, 999, 999, 999, 999, 999, 999, 999, 999, 999, 999],
      [999, 999, 999, 999, 999, 999, 999, 999, 999, 999, 999, 999, 999, 999, 999, 999, 999, 999, 999, 999, 999, 999, 999, 999, 999, 999, 999, 999, 999],
      [999, 999, 999, 999, 999, 999, 999, 999, 999, 999, 999, 999, 999, 999, 999, 999, 999, 999, 999, 999, 999, 999, 999, 999, 999, 999, 999, 999, 999],
      [999, 999, 999, 999, 999, 999, 999, 999, 999, 999, 999, 999, 999, 999, 999, 999, 999, 999, 999, 999, 999, 999, 999, 999, 999, 999, 999, 999, 999],
      [999, 999, 999, 999, 999, 999, 999, 999, 999, 999, 999, 999, 999, 999, 999, 999, 999, 999, 999, 999, 999, 999, 999, 999, 999, 999, 999, 999, 999],
      [999, 999, 999, 999, 999, 999, 999, 999, 999, 999, 999, 999, 999, 999, 999, 999, 999, 999, 999, 999, 999, 999, 999, 999, 999, 999, 999, 999, 999],
      [999, 999, 999, 999, 999, 999, 999, 999, 999, 999, 999, 999, 999, 999, 999, 999, 999, 999, 999, 999, 999, 999, 999, 999, 999, 999, 999, 999, 999],
      [999, 999, 999, 999, 112, 112, 112, 999, 999, 999, 999, 999, 999, 999, 999, 999, 999, 999, 999, 999, 999, 999, 999, 999, 999, 999, 999, 999, 999],
      [999, 999, 999, 999, 112, 112, 112, 112, 999, 999, 999, 999, 999, 999, 999, 999, 999, 999, 999, 999, 999, 999, 999, 999, 999, 999, 999, 999, 999],
      [999, 112, 112, 112, 112, 112, 112, 112, 112, 112, 112, 112, 112, 999, 999, 999, 112, 112, 999, 999, 999, 999, 999, 999, 999, 999, 999, 999, 999],
      [999, 112, 112, 112, 112, 112, 112, 112, 112, 112, 112, 112, 112, 999, 999, 999, 112, 112, 112, 112, 112, 112, 112, 112, 112, 112, 112, 112, 999],
      [999, 999, 999, 999, 999, 999, 999, 999, 999, 999, 999, 999, 999, 999, 999, 999, 999, 999, 999, 999, 999, 999, 999, 999, 999, 999, 999, 999, 999]
    ]
  ]
}